111111111111111111111111111
100000000000000000000000001
111111000000000000000000001
100000000000000000001111111
100000111111110000000000001
100000000000000001111100001
111111000000000110000000001
100000111111110010000000001
100000000000000000000000001
100000000000000000001111111
100000000N00000000000000001
111111111111111111111111111