111111111111111111111111111
100000000000000000000000001
111111000000000000000000001
100000000000000000001111111
100000111111110000000000001
100000000000000001111100001
1111110000000N0000000000001
100000111111110000000000001
100000000000000000000000001
100000000000000000001111111
100000000000000000000000001
111111111111111111111111111