SO texture/red.xpm
NO texture/a.xpm
WE texture/w.xpm
EA texture/grey.xpm

F 255,112,0
C 225,0,60

111111111111111111111111111111111111111111111111111111111111111111111111
110000001000001011110110000000000000000000000000000000000000000000000001
110000001000001011110110000000000000000000000000000000000000000000000001
110000001000001011110110000000000000000000000000000000000000000000000001
100000000000000000000000000000000000000011111111111111110000000000000001
100000000000000011010100000000000000000000000000000000000000000000000001
110000001000001011110111000000000000000000000000000000000000000000000001
11110111 1110101 1111101000000000000000000000000000000000000000000000001
111111011101111111100000000000000000000000000000000000000000000000000111
111111111111111111111100000000000000000011111111000000000000000000000001
100000000000000000000000000000000000000000000000000000000000000000000111
100000000000000011010101000000000000000000000000000000000000000000111
110000001000001011110111000000000000000011111111111111111111100000000111
11110111 1110101 1111101000000000000001111111100000000000000000000000001
100000001000000010000001000000000000000000000000000000000000000000000001
100000000000000011010101000000000111111111111110000000000000000000000001
110000001000001011110111000000001              1000000000000000000000001
11110111 1110101 1111101000000000111111111111  1000000000000000000000001
10000000100000001000000100000000000000000001   1000000000000000000000001
100000000000000011010101000000000000011111111110000000000000000000000001
110000001000001011110111000000000000000000000000000000000000000000000001
11110111 1110101 1111101000000000000000000000000000000000N00000000000001
100000001000000010000001000000000000000000000000000000000000000000000001
100000000000000011010101000000000000000000000000000000000000000000000001
110000001000001011110111000000000000000000000000000000000000000000000001
11110111 1110101 1111101000000000000000000000000000000000000000000000001
111111111111000010000000000000000000000000000000000000000000000000000001
111111111111111111111111111111111111111111111111111111111111111111111111
