SO texture/red.xpm
NO texture/a.xpm
WE texture/w.xpm
EA    texture/grey.xpm

F 128,128,128
C 135,206,235

        1111111111111111111111111
        1000000000110000000000001
        1011000001110000000000001
        10010000000000000000000001
1111111110110000011100000111111111       
100000000011000001111111111              
11110111111111011101 1010001              
11110111111111011111111110001
11000000110101011100000010001
10000000N00000001100000010001
10000000000000001111111110001
110000011101010111110111100111
11110111 1110101 101111010001
11111111 1111111 111111111111
