SO texture/red.xpm
NO texture/a.xpm
WE texture/w.xpm
EA texture/grey.xpm

F 211,211,211
C 135,206,235

111111111111111111111111
100011010000001100000001 
1011 1001111000000000001
100110000001000000000001
11111111101 100N01111111
1000000001 1000011101111
11110111111 110111000001
111101    11101110101001
110000111101010111000001
100000100100010110000011
100001011100010011010101
110000111101010111101111
11110111 1110101 1111101
111111111111111111111111
