SO texture/red.xpm
NO texture/a.xpm
WE texture/w.xpm
EA texture/grey.xpm

F 220,100,0
C 225,30,0

        1111111111111111111111111
        1000000000110000000000001
        10110000011100000000000011111111111111111111111111111
        10010000000000000000000011111111111000000001100000111
11111111101100000111000000000001111111111111111111000000001
1000000000110000011101111111111111111111111111110000011110011
1111011111111101110000001000111111111111111111111111111111111
11110111111111011101010010001
11000000110101011100000010001
10000000000000001100000010001
10000000000000001101010010001
110000011101010111110111100111
11110111 1110101 101111010001
11111111 1111111 111111111111