SO texture/red.xpm
NO texture/a.xpm
WE teexture/w.xpm
EA texture/grey.xpm

F 255,112,11
C 225,0,119

111111111111111111
100000000000000001
100000000000000001
100000000000000001
100000001000000001
100000000000000001
10000000N000000001
111111111111111111