SO texture/red.xpm
NO texture/a.xpm
WE texture/w.xpm
EA texture/grey.xpm

F 128,128,128
C 135,206,235

11111111111111111111111111111111
100000000000000E0000000000000001
10001111100111111111100111110001
10001000000000000000000000010001
10000000101010101010101000000001
10000000000000000000000000000001
10000011000111111111110011000001
10000010000000000000000001000001
10000000000000000000000000000001
10000000000011111111000000000001
1000001000001      1000001000001
1000001000001      1000001000001
10000000000011111111000000000001
10000000000000000000000000000001
10000010000000000000000001000001
10000011000111111111110011000001
10000000000000000000000000000001
10000000101010101010101000000001
10001000000000000000000000010001
10001111100111111111100111110001
10000000000000000000000000000001
11111111111111111111111111111111